{
  "A": "L", "B": "L", "C": "L", "D": "L", "E": "L",
  "F": "L", "G": "L", "H": "L", "I": "L", "J": "L",
  "K": "L", "L": "L", "M": "L", "N": "L", "O": "L",
  "P": "L", "Q": "L", "R": "L", "S": "L", "T": "L",
  "U": "L", "V": "L", "W": "L", "X": "L", "Y": "L", "Z": "L",
  
  "a": "L", "b": "L", "c": "L", "d": "L", "e": "L",
  "f": "L", "g": "L", "h": "L", "i": "L", "j": "L",
  "k": "L", "l": "L", "m": "L", "n": "L", "o": "L",
  "p": "L", "q": "L", "r": "L", "s": "L", "t": "L",
  "u": "L", "v": "L", "w": "L", "x": "L", "y": "L", "z": "L",

  "0": "N", "1": "N", "2": "N", "3": "N", "4": "N",
  "5": "N", "6": "N", "7": "N", "8": "N", "9": "N",

  "!": "S", "\"": "S", "#": "S", "$": "S", "%": "S",
  "&": "S", "'": "S", "(": "S", ")": "S", "*": "S",
  "+": "S", ",": "S", "-": "S", ".": "S", "/": "S",
  ":": "S", ";": "S", "<": "S", "=": "S", ">": "S", "?": "S",
  "@": "S", "[": "S", "\\": "S", "]": "S", "^": "S",
  "_": "S", "`": "S", "{": "S", "|": "S", "}": "S", "~": "S"
}
